"lang"
{
"Language"	"korean"
"Tokens"
{
"App_SpecialOffers"	"특전 제공"
"[english]App_SpecialOffers"	"Special Offers"
"App_Friends"	"친구"
"[english]App_Friends"	"Friends"
"App_Games"	"게임 플레이하기"
"[english]App_Games"	"Play Games"
"App_Storefront"	"게임 검색"
"[english]App_Storefront"	"Browse Games"
"App_Servers"	"서버"
"[english]App_Servers"	"Servers"
"App_Browser"	"웹 브라우저"
"[english]App_Browser"	"Web browser"
"Admin_Servers"	"내 서버"
"[english]Admin_Servers"	"My Servers"
"App_Account"	"계정"
"[english]App_Account"	"Account"
"App_Settings"	"설정"
"[english]App_Settings"	"Settings"
"App_Monitor"	"모니터"
"[english]App_Monitor"	"Monitor"
"App_News"	"뉴스"
"[english]App_News"	"News"
}
}
