"lang"
{
"Language"	"italian"
"Tokens"
{
"App_SpecialOffers"	"Offerte speciali"
"[english]App_SpecialOffers"	"Special Offers"
"App_Friends"	"Amici"
"[english]App_Friends"	"Friends"
"App_Games"	"Gioca"
"[english]App_Games"	"Play Games"
"App_Storefront"	"Visualizza giochi"
"[english]App_Storefront"	"Browse Games"
"App_Servers"	"Server"
"[english]App_Servers"	"Servers"
"App_Browser"	"Navigatore Web"
"[english]App_Browser"	"Web browser"
"Admin_Servers"	"I miei server"
"[english]Admin_Servers"	"My Servers"
"App_Account"	"Profilo"
"[english]App_Account"	"Account"
"App_Settings"	"Impostazioni"
"[english]App_Settings"	"Settings"
"App_Monitor"	"Monitor"
"[english]App_Monitor"	"Monitor"
"App_News"	"Notizie"
"[english]App_News"	"News"
}
}
