"lang"
{
"Language"	"german"
"Tokens"
{
"App_SpecialOffers"	"Sonderangebote"
"[english]App_SpecialOffers"	"Special Offers"
"App_Friends"	"Freunde"
"[english]App_Friends"	"Friends"
"App_Games"	"Spiele spielen"
"[english]App_Games"	"Play Games"
"App_Storefront"	"Spiele suchen"
"[english]App_Storefront"	"Browse Games"
"App_Servers"	"Server"
"[english]App_Servers"	"Servers"
"App_Browser"	"Internet-Browser"
"[english]App_Browser"	"Web browser"
"Admin_Servers"	"Meine Server"
"[english]Admin_Servers"	"My Servers"
"App_Account"	"Account"
"[english]App_Account"	"Account"
"App_Settings"	"Einstellungen"
"[english]App_Settings"	"Settings"
"App_Monitor"	"Monitor"
"[english]App_Monitor"	"Monitor"
"App_News"	"Neuigkeiten"
"[english]App_News"	"News"
}
}
