"lang"
{
"Language"	"finnish"
"Tokens"
{
"App_SpecialOffers"	"Erikoistarjoukset"
"[english]App_SpecialOffers"	"Special Offers"
"App_Friends"	"Kaverit"
"[english]App_Friends"	"Friends"
"App_Games"	"Pelaa pelejä"
"[english]App_Games"	"Play Games"
"App_Storefront"	"Selaa pelejä"
"[english]App_Storefront"	"Browse Games"
"App_Servers"	"Palvelimet"
"[english]App_Servers"	"Servers"
"App_Browser"	"Web-selain"
"[english]App_Browser"	"Web browser"
"Admin_Servers"	"Omat palvelimet"
"[english]Admin_Servers"	"My Servers"
"App_Account"	"Tili"
"[english]App_Account"	"Account"
"App_Settings"	"Asetukset"
"[english]App_Settings"	"Settings"
"App_Monitor"	"Seuranta"
"[english]App_Monitor"	"Monitor"
"App_News"	"Uutiset"
"[english]App_News"	"News"
}
}
