"lang"
{
"Language"	"swedish"
"Tokens"
{
"App_SpecialOffers"	"Specialerbjudanden"
"[english]App_SpecialOffers"	"Special Offers"
"App_Friends"	"Vänner"
"[english]App_Friends"	"Friends"
"App_Games"	"Spela spel"
"[english]App_Games"	"Play Games"
"App_Storefront"	"Bläddra genom spel"
"[english]App_Storefront"	"Browse Games"
"App_Servers"	"Servrar"
"[english]App_Servers"	"Servers"
"App_Browser"	"Webbläsare"
"[english]App_Browser"	"Web browser"
"Admin_Servers"	"Mina servrar"
"[english]Admin_Servers"	"My Servers"
"App_Account"	"Konto"
"[english]App_Account"	"Account"
"App_Settings"	"Inställningar"
"[english]App_Settings"	"Settings"
"App_Monitor"	"Skärm"
"[english]App_Monitor"	"Monitor"
"App_News"	"Nyheter"
"[english]App_News"	"News"
}
}
