"lang"
{
"Language"	"portuguese"
"Tokens"
{
"App_SpecialOffers"	"Ofertas especiais"
"[english]App_SpecialOffers"	"Special Offers"
"App_Friends"	"Amigos"
"[english]App_Friends"	"Friends"
"App_Games"	"Jogar"
"[english]App_Games"	"Play Games"
"App_Storefront"	"Procurar jogos"
"[english]App_Storefront"	"Browse Games"
"App_Servers"	"Servidores"
"[english]App_Servers"	"Servers"
"App_Browser"	"Browser da Web"
"[english]App_Browser"	"Web browser"
"Admin_Servers"	"Meus servidores"
"[english]Admin_Servers"	"My Servers"
"App_Account"	"Conta"
"[english]App_Account"	"Account"
"App_Settings"	"Definições"
"[english]App_Settings"	"Settings"
"App_Monitor"	"Monitor"
"[english]App_Monitor"	"Monitor"
"App_News"	"Notícias"
"[english]App_News"	"News"
}
}
